................................................................................
................................................................................
................................................................................
................................................................................
................................................................................
................................................................................
................................................................................
................................................................................
................................................................................
................................................................................
................................................................................
................................................................................
................................................................................
................................................................................
................................................................................
................................................................................
................................................................................
................................................................................
................................................................................
................................======..........................................
..............................=========.........................................
.............................===@@@@@@===.......................................
............................===@@@@@F@@===......................................
............................===@@@@@@@@===......................................
............................====@@@@@@====......................................
...........................===============......................................
...........................===============......................................
...........................==============.......................................
...........................==============.......................................
..........................===============.......................................
.........................=================......................................
........................==================......................................
.......................===================......................................
......................====================......................................
....................======================......................................
...................=======================......................................
...................=======================......................................
.................=========================......................................
.................=========================......................................
................=========================.......................................
................========================........................................
................========================........................................
................=======================.........................................
...............========================.........................................
...............=========================........................................
...............=========================........................................
...............=========================........................................
................========================........................................
................=======================.........................................
................=======================.........................................
.................=====================..........................................
..................========DDD========...........................................
...................======DDTDD======............................................
....................=====DDDDD====..............................................
......................==========................................................
................................................................................
................................................................................
................................................................................
................................................................................
................................................................................
................................................................................
................................................................................
................................................................................
................................................................................
................................................................................
